что-что |
где-то                        |
как-нибудь                   |
когда-нибудь               |
какой-нибудь              |
кто-либо                 |
зачем-либо              |
почему-нибудь          |
только-только         |
оно-то               |
они-то              |
она-то             |
он-то             |
чем-то           |
из-под          |
только-то      |
чуть-чуть     |
какой-то     |
какая-то    |
наконец-то |
отчего-то |
зачем-то  |
почему-то  |
как-то      |
что-то       |
кто-то        |
что-нибудь     |
чего-нибудь     |
когда-то         |
куда-то           |
из-за              |
своём |
своем |
своя |
своего |
свой |
которыми |
которые |
которого    |
которым    |
которую   |
который  |
которых |
весь           |
это            | Это и выше -- добавлено Антоном
и              | and
в              | in/into
во             | alternative form
не             | not
что            | what/that
он             | he
на             | on/onto
я              | i
с              | from
со             | alternative form
как            | how
а              | milder form of `no' (but)
то             | conjunction and form of `that'
все            | all
она            | she
так            | so, thus
его            | him
но             | but
да             | yes/and
ты             | thou
к              | towards, by
у              | around, chez
же             | intensifier particle
вы             | you
за             | beyond, behind
бы             | conditional/subj. particle
по             | up to, along
только         | only
ее             | her
мне            | to me
было           | it was
вот            | here is/are, particle
от             | away from
меня           | me
еще            | still, yet, more
нет            | no, there isnt/arent
о              | about
из             | out of
ему            | to him
теперь         | now
когда          | when
даже           | even
ну             | so, well
вдруг          | suddenly
ли             | interrogative particle
если           | if
уже            | already, but homonym of `narrower'
или            | or
ни             | neither
быть           | to be
был            | he was
него           | prepositional form of его
до             | up to
вас            | you accusative
нибудь         | indef. suffix preceded by hyphen
опять          | again
уж             | already, but homonym of `adder'
вам            | to you
сказал         | he said
ведь           | particle `after all'
там            | there
потом          | then
себя           | oneself
ничего         | nothing
ей             | to her
может          | usually with `быть' as `maybe'
они            | they
тут            | here
где            | where
есть           | there is/are
надо           | got to, must
ней            | prepositional form of  ей
для            | for
мы             | we
тебя           | thee
их             | them, their
чем            | than
была           | she was
сам            | self
чтоб           | in order to
без            | without
будто          | as if
человек        | man, person, one
чего           | genitive form of `what'
раз            | once
тоже           | also
себе           | to oneself
под            | beneath
жизнь          | life
будет          | will be
ж              | short form of intensifer particle `же'
тогда          | then
кто            | who
этот           | this
говорил        | was saying
того           | genitive form of `that'
потому         | for that reason
этого          | genitive form of `this'
какой          | which
совсем         | altogether
ним            | prepositional form of `его', `они'
здесь          | here
этом           | prepositional form of `этот'
один           | one
почти          | almost
мой            | my
тем            | instrumental/dative plural of `тот', `то'
чтобы          | full form of `in order that'
нее            | her (acc.)
кажется        | it seems
сейчас         | now
были           | they were
куда           | where to
зачем          | why
сказать        | to say
всех           | all (acc., gen. preposn. plural)
никогда        | never
сегодня        | today
можно          | possible, one can
при            | by
наконец        | finally
два            | two
об             | alternative form of `о', about
другой         | another
хоть           | even
после          | after
над            | above
больше         | more
тот            | that one (masc.)
через          | across, in
эти            | these
нас            | us
про            | about
всего          | in all, only, of all
них            | prepositional form of `они' (they)
какая          | which, feminine
много          | lots
разве          | interrogative particle
сказала        | she said
три            | three
эту            | this, acc. fem. sing.
моя            | my, feminine
впрочем        | moreover, besides
хорошо         | good
свою           | ones own, acc. fem. sing.
этой           | oblique form of `эта', fem. `this'
перед          | in front of
иногда         | sometimes
лучше          | better
чуть           | a little
том            | preposn. form of `that one'
нельзя         | one must not
такой          | such a one
им             | to them
более          | more
всегда         | always
конечно        | of course
всю            | acc. fem. sing of `all'
между          | between
наш   |
год |